NO ./textures/tiles/north.xpm
SO ./textures/tiles/south.xpm
EA ./textures/tiles/south.xpm
WE ./textures/tiles/south.xpm

C 100,100,160
F 15,111,154

11111111111111111
10000000000000001
10000000000000001
10000000000000001
100000111100X0001
10000010000000001
10000010000000001
10000010000000001
100000E0000000001
10000010000000001
10100000000001001
10000000000000001
11111111111111111
