NO ./textures/tiles/north.xpm
SO ./textures/tiles/south.xpm
EA ./textures/tiles/south.xpm
WE ./textures/tiles/south.xpm

C 155,100,160
F 111,111,111

                                           11111
    11111                                 11000111111111
11111M00H111111111                       11000000000001
1001K0000000000011111111111111111111111111000000X00001
101P10001B00000000D00000000000D00000000000000000000001
1I0000N00000000011111111111111111111111111111111111111
1J000000100010001
1T00000000000001
10101610001616161
10000000000000001
10001000100100001
10000000000000001
10100000100001001
10000000000000001
11111D11111111111
    101
11111D11111111111
10000000000000001
10100000100000101
10000000000000001
10001000100010001
10000000000000001
10100001D10000101
10000010001000001
10000100000100001
10001000000010001
1001000BBB0001001
10100000000000101
11111111111111111
